NO      ./textures/pussy.xpm
SO      ./textures/doom.xpm
EA      ./textures/hkaddour.xpm
WE      ./textures/yaskour.xpm


C       21474836490,194,251
F       104,247,162

        1111111111111111111111111
        1000000000000000000000011
        1000000000000000000000001
        1000000000000000000000001
111111111000000000000000000000001
100000000000000000000000000001111
10000000000000W00000000000001
10000000000000000000000000001
10000000000000000000000000001
10000000000000000000000000001
10000000000000000000000000001
1100000111000001110000000000111
11110101 1111101 101111010001
11111111 111 111 111111111111
