NO      ./textures/putin.xpm
SO      ./textures/psycho.xpm
EA      ./textures/kgb.xpm
WE      ./textures/hitler.xpm


C       21474836490,194,251
F       104,247,162

1111111
1100011
100S001
1100011
1111111
