NO      ./textures/putin.xpm
SO      ./textures/psycho.xpm
EA      ./textures/kgb.xpm
WE      ./textures/hitler.xpm


C       2,194,251
F       104,247,162

        1111111111111111111111111
        1000100001100000000000001
        1011011001110001101010001
        1001000000000101010101001
111111111011000001110101000000001
100000000011000001110101101001111
11110111111111011100000W10101
11110111111111011101010000001
11000000110101011100000010001
10000000000000000000000000001
10000000000000001100000010001
1100000111010101110000111000111
11110101 1111101 101111010001
11111111 111 111 111111111111
