NO      ./textures/pussy.xpm
SO      ./textures/doom.xpm
EA      ./textures/hkaddour.xpm
WE      ./textures/yaskour.xpm


F       188,0,122
C       115,194,251

   111111111111111
111000000000001111
100111000000001
1001 1000000001
100010000000001
1000W0000000001
111111111111111
