NO      ./textures/pussy.xpm
SO      ./textures/doom.xpm
EA      ./textures/hkaddour.xpm
WE      ./textures/yaskour.xpm


C       21474836490,194,251
F       104,247,162

        1111111111111111111111111
        1000000000000000000000001
        1000000000000000000000001
        1000000000000000000000001
111111111000000000000000000000001
100000000000000000000000000001111
10000000000000000000S00000001
10000000000000000000000000001
10000000000000000000000000001
10000000000000000000000000001
10000000000000000000000000001
1000000010000000100000000000111
10000001 1001001 100000000001
11111111 111 111 111111111111
